1
6
######
#X.T.#
#X##.#
#.##X#
E....#
######
