1
6
######
#X.T.#
#X##.#
#.##.#
E....#
######
